0 0 0 0 0 0 0 0 0 0 0 0 0 0 0 0 0 0 0 0 0 0 0 0 0 0 0 0 0 0 0 0 0 0 0 0 0 0 0 0 ﻿0 0 0 0 0 0 0 0 0 0 0 0 0 0 0 0 0 0 0 0
0 0 0 0 0 0 0 0 0 0 0 0 0 0 0 0 0 0 0 0 0 0 0 0 0 0 0 0 0 0 0 0 0 0 0 0 0 0 0 0 ﻿0 0 0 0 0 0 0 0 0 0 0 0 0 0 0 0 0 0 0 0
0 0 0 0 0 0 0 0 0 0 0 0 0 0 0 0 0 0 0 0 0 0 0 0 0 0 0 0 0 0 0 0 0 0 0 0 0 0 0 0 ﻿0 0 0 0 0 0 0 0 0 0 0 0 0 0 0 0 0 0 0 0
0 0 0 0 0 0 0 0 0 0 0 0 0 0 0 0 0 0 0 0 0 0 0 0 0 0 0 0 0 0 0 0 0 0 0 0 0 0 0 0 ﻿0 0 0 0 0 0 0 0 0 0 0 0 0 0 0 0 0 0 0 0
1 5 4 5 0 0 4 4 4 4 1 4 4 4 4 1 4 4 0 0 4 4 4 ﻿0 0 0 0 0 0 0 0 0 0 0 0 0 0 0 0 0 4 4 5 4 0 0 0 0 0 0 0 0 3 0 0 0 0 0 0 0
2 3 4 5 0 0 1 4 4 4 2 4 1 4 1 5 4 4 0 0 4 4 4 5 0 0 0 0 0 0 0 0 0 0 0 0 0 0 0 0 ﻿4 4 4 5 6 0 0 0 0 0 0 4 2 5 0 0 0 0 0 0
1 5 4 5 0 0 5 1 4 4 1 4 1 4 1 5 4 4 0 0 4 4 4 5 0 0 0 0 0 0 0 0 0 0 0 0 0 0 0 0 ﻿4 4 4 5 7 5 0 0 0 0 7 6 1 7 4 0 0 0 0 0
2 3 4 5 0 0 4 5 4 4 1 4 1 4 1 5 4 4 0 0 4 4 4 5 0 0 0 0 0 0 0 0 0 0 0 0 0 0 0 0 4 4 4 5 4 4 4 5 4 4 4 5 4 4 4 5 4 4 4 5
1 5 4 5 0 0 6 7 4 4 2 4 1 4 1 5 4 4 0 0 4 4 4 5 0 0 0 0 0 0 0 0 0 0 0 0 0 0 0 0 ﻿4 4 4 5 4 4 4 5 4 4 4 5 4 4 4 5 4 4 4 5
2 3 4 5 0 0 7 5 4 4 3 4 1 4 1 5 4 4 0 0 4 4 4 5 0 0 0 0 0 0 0 0 0 0 0 0 0 0 0 0 4 4 4 5 4 4 4 5 4 4 4 5 4 4 4 5 4 4 4 5
2 3 4 5 0 0 5 7 4 4 5 4 1 4 1 5 4 4 0 0 4 4 4 5 0 0 0 0 0 0 0 0 0 0 0 0 0 0 0 0 4 4 4 5 4 4 4 5 4 4 4 5 4 4 4 5 4 4 4 5
2 3 4 5 0 0 5 5 4 4 6 4 1 4 1 5 4 4 0 0 4 4 4 5 0 0 0 0 0 0 0 0 0 0 0 0 0 0 0 0 ﻿4 4 4 5 0 0 0 0 0 0 0 0 0 0 0 0 0 0 0 0
2 3 4 5 0 0 4 4 4 4 5 6 4 4 1 5 4 4 4 4 4 4 4 5 0 0 0 0 0 0 0 0 0 0 0 0 0 0 0 0 ﻿4 4 4 5 0 0 0 0 0 0 0 0 0 0 0 0 0 0 0 0
1 5 4 5 0 0 4 4 1 1 5 6 1 5 1 5 4 4 4 4 4 4 4 5 0 0 0 0 0 0 0 0 0 0 0 0 0 0 0 0 ﻿4 4 4 5 0 0 0 0 0 0 0 0 0 0 0 0 0 0 0 0
1 5 4 5 0 0 4 4 1 1 5 6 1 5 1 5 4 4 4 4 4 4 4 5 4 5 4 5 4 5 4 5 4 5 4 5 4 5 4 5 4 4 4 5 0 0 0 0 0 0 0 0 0 0 0 0 0 0 0 0
1 5 4 5 0 0 4 4 1 1 5 6 1 5 1 5 4 4 4 4 4 4 4 5 4 5 4 5 4 5 4 5 4 5 4 5 4 5 4 5 4 4 4 5 0 0 0 0 0 0 0 0 0 0 0 0 0 0 0 0
2 3 4 5 0 0 4 4 1 1 5 6 1 5 1 5 4 4 4 4 4 4 4 5 4 5 4 5 4 5 4 5 4 5 4 5 4 5 4 5 4 4 4 5 0 0 0 0 0 0 0 0 0 0 0 0 0 0 0 0
2 3 4 5 0 0 4 4 1 1 5 6 1 5 1 5 4 4 4 4 4 4 4 5 4 5 4 5 4 5 4 5 4 5 4 5 4 5 4 5 4 4 4 5 0 0 0 0 0 0 0 0 0 0 0 0 0 0 0 0
1 5 4 5 0 0 4 4 1 1 5 6 1 5 1 5 4 4 4 4 4 4 4 5 4 5 4 5 4 5 4 5 4 5 4 5 4 5 4 5 4 4 4 5 0 0 0 0 0 0 0 0 0 0 0 0 0 0 0 0
1 5 4 5 0 0 4 4 1 1 5 6 1 5 1 5 4 4 4 4 4 4 4 5 4 5 4 5 4 5 4 5 4 5 4 5 4 5 4 5 4 4 4 5 0 0 0 0 0 0 0 0 0 0 0 0 0 0 0 0
1 5 4 5 0 0 4 4 1 1 5 6 1 5 1 5 4 4 4 4 4 4 0 0 0 0 0 0 0 0 0 0 0 0 0 0 0 0 0 0 ﻿0 0 0 0 0 0 0 0 0 0 0 0 0 0 0 0 0 0 0 0
1 5 4 5 0 0 4 4 1 1 5 6 1 5 1 5 4 4 4 4 4 4 0 0 0 0 0 0 0 0 0 0 0 0 0 0 0 0 0 0 ﻿0 0 0 0 0 0 0 0 0 0 0 0 0 0 0 0 0 0 0 0
1 5 4 5 0 0 4 4 1 1 5 6 1 5 1 5 4 4 4 4 4 4 0 0 0 0 0 0 0 0 0 0 0 0 0 0 0 0 0 0 ﻿0 0 0 0 0 0 0 0 0 0 0 0 0 0 0 0 0 0 0 0
1 5 4 5 0 0 4 4 1 1 5 6 1 5 1 5 4 4 4 4 4 4 0 0 0 0 0 0 0 0 0 0 0 0 0 0 0 0 0 0 ﻿0 0 0 0 0 0 0 0 0 0 0 0 0 0 0 0 0 0 0 0
1 5 4 5 0 0 4 4 1 1 5 6 1 5 1 5 4 4 4 4 4 4 0 0 0 0 0 0 0 0 0 0 0 0 0 0 0 0 0 0 ﻿0 0 0 0 0 0 0 0 0 0 0 0 0 0 0 0 0 0 0 0
0 0 0 0 0 0 4 4 1 1 5 6 1 5 1 5 4 4 4 4 4 4 0 0 0 0 0 0 0 0 0 0 0 0 0 0 0 0 0 0 ﻿0 0 0 0 0 0 0 0 0 0 0 0 0 0 0 0 0 0 0 0
0 0 0 0 0 0 4 4 1 1 5 6 1 5 1 5 4 4 4 4 4 4 0 0 0 0 0 0 0 0 0 0 0 0 0 0 0 0 0 0 0 0 ﻿0 0 0 0 0 0 0 0 0 0 0 0 0 0 0 0 0 0
0 0 0 0 0 0 4 4 1 1 5 6 1 5 1 5 4 4 4 4 4 4 0 0 0 0 0 0 0 0 0 0 0 0 0 0 0 0 0 0 0 0 ﻿0 0 0 0 0 0 0 0 0 0 0 0 0 0 0 0 0 0
0 0 0 0 0 0 4 4 1 1 5 6 1 5 1 5 4 4 4 4 4 4 0 0 0 0 0 0 0 0 0 0 0 0 0 0 0 0 0 0 0 0 ﻿0 0 0 0 0 0 0 0 0 0 0 0 0 0 0 0 0 0
2 3 4 5 0 0 4 4 1 1 5 6 1 5 1 5 4 4 4 4 4 4 0 0 0 0 0 0 0 0 0 0 0 0 0 0 0 0 0 0 0 0 ﻿0 0 0 0 0 0 0 0 0 0 0 0 0 2 1 5 6 7
2 3 4 5 0 0 4 4 1 1 5 6 1 5 1 5 4 4 4 4 4 4 0 0 0 0 0 0 0 0 0 0 0 0 0 0 0 0 0 0 ﻿0 0 0 0 0 0 0 0 0 0 0 0 0 0 0 2 1 5 6 7
2 3 4 5 0 0 4 4 1 1 5 6 1 5 1 5 4 4 4 4 4 4 0 0 0 0 0 0 0 0 0 0 0 0 0 0 0 0 0 0 ﻿0 0 0 0 0 0 0 0 0 0 0 0 0 0 0 2 1 5 6 7
2 3 4 5 0 0 4 4 1 1 5 6 1 5 1 5 4 4 4 4 4 4 0 0 0 0 0 0 0 0 0 0 0 0 0 0 0 0 0 0 ﻿0 0 0 0 0 0 0 0 0 0 0 0 0 0 0 2 1 5 6 7
1 5 4 5 0 0 4 4 1 1 5 6 1 5 1 5 4 4 4 4 4 4 0 0 0 0 0 0 0 0 0 0 0 0 0 0 0 0 0 0 ﻿0 0 0 0 0 0 0 0 0 0 0 0 0 0 0 2 1 5 6 7
1 5 4 5 0 0 4 4 1 1 5 6 1 5 1 5 4 4 4 4 4 4 0 0 0 0 0 0 0 1 4 5 1 5 4 5 1 5 4 5 1 0 ﻿0 0 0 0 0 0 0 0 0 0 0 0 0 2 1 5 6 7
1 5 4 5 0 0 4 4 1 1 5 6 1 5 1 5 4 4 4 4 4 4 0 0 0 0 0 0 5 1 4 5 1 5 4 5 1 5 4 5 1 0 ﻿0 0 0 0 0 0 0 0 0 0 0 0 0 2 1 5 6 7
2 3 4 5 0 0 0 0 0 0 0 0 0 0 0 0 0 0 0 0 0 0 0 0 0 0 0 7 5 4 4 5 1 5 4 5 1 5 4 5 1 0 0 0 0 0 0 0 1 7 5 2 5 5 4 2 1 5 6 7
2 3 4 5 0 0 0 0 0 0 0 0 0 0 0 0 0 0 0 0 0 0 0 0 0 0 5 4 5 6 4 5 1 5 4 5 1 5 4 5 1 0 0 0 0 0 0 7 5 5 2 1 7 5 2 1 2 4 5 7
1 5 4 5 0 0 0 0 0 0 0 0 0 0 0 0 0 0 0 0 0 0 0 0 0 4 7 6 2 1 4 5 1 5 4 5 1 5 4 5 1 0 0 0 0 0 7 5 4 1 7 6 7 5 5 7 6 5 7 6
1 5 4 5 1 5 4 5 1 5 4 5 1 5 4 5 1 5 4 5 1 5 4 5 1 5 4 5 1 5 4 5 1 5 4 5 1 5 4 5 1 5 4 5 1 5 4 5 1 5 4 5 1 5 4 5 1 5 4 5
